     \\|||//
    ==(`^')==      ^
    __/\~/\__      |
   /         \     |
  | |       | |    |
  | |_______| |___ |
  | |       |_____(|)
  | |   |   |      |
  (_)___|___|      |
     | | | |       |
     | | | |       |
     | | | |       |
    /__| |__\      |
